"","Year","Country","Goals.conceded","Goals.Scored","Touranaments.played","Friendlys.played","Matches.played","Goal.Diiference","Matches.Won","Matches.draw","Matches.lost","Tournaments.won","overall","attack","midfield","defense","true_estimate"
"1",2005,"Argentina",2,8,4,0,4,6,4,0,0,4,NA,NA,NA,NA,NA
"2",2005,"Australia",7,21,4,4,8,14,6,0,2,2,NA,NA,NA,NA,NA
"3",2005,"Belgium",3,14,3,1,4,11,3,0,1,2,NA,NA,NA,NA,NA
"4",2005,"Brazil",2,23,6,1,7,21,7,0,0,6,NA,NA,NA,NA,NA
"5",2005,"Colombia",9,17,6,2,8,8,4,1,3,3,NA,NA,NA,NA,NA
"6",2005,"Costa Rica",13,21,8,2,10,8,6,2,2,6,NA,NA,NA,NA,NA
"7",2005,"Croatia",1,9,3,1,4,8,3,1,0,3,NA,NA,NA,NA,NA
"8",2005,"Denmark",3,17,4,1,5,14,5,0,0,4,NA,NA,NA,NA,NA
"9",2005,"Egypt",7,28,3,6,9,21,7,1,1,3,NA,NA,NA,NA,NA
"10",2005,"England",3,12,4,2,6,9,5,1,0,4,NA,NA,NA,NA,NA
"11",2005,"France",4,16,3,5,8,12,5,3,0,2,NA,NA,NA,NA,NA
"12",2005,"Germany",17,24,5,4,9,7,5,3,1,3,NA,NA,NA,NA,NA
"13",2005,"Iceland",8,11,3,1,4,3,2,0,2,1,NA,NA,NA,NA,NA
"14",2005,"Iran",3,14,3,4,7,11,7,0,0,3,NA,NA,NA,NA,NA
"15",2005,"Japan",14,23,8,4,12,9,7,2,3,3,NA,NA,NA,NA,NA
"16",2005,"Korea Republic",7,15,6,6,12,8,6,3,3,2,NA,NA,NA,NA,NA
"17",2005,"Mexico",13,32,10,7,17,19,10,5,2,8,NA,NA,NA,NA,NA
"18",2005,"Morocco",3,11,4,2,6,8,4,1,1,4,NA,NA,NA,NA,NA
"19",2005,"Nigeria",2,8,3,0,3,6,2,1,0,2,NA,NA,NA,NA,NA
"20",2005,"Panama",11,4,7,0,7,7,0,3,4,0,NA,NA,NA,NA,NA
"21",2005,"Peru",4,9,4,1,5,5,2,3,0,1,NA,NA,NA,NA,NA
"22",2005,"Poland",12,27,4,6,10,15,9,0,1,4,NA,NA,NA,NA,NA
"23",2005,"Portugal",2,21,4,3,7,19,7,0,0,4,NA,NA,NA,NA,NA
"24",2005,"Russia",1,9,4,0,4,8,3,1,0,3,NA,NA,NA,NA,NA
"25",2005,"Saudi Arabia",9,17,3,7,10,8,6,1,3,3,NA,NA,NA,NA,NA
"26",2005,"Senegal",3,11,3,1,4,8,2,2,0,2,NA,NA,NA,NA,NA
"27",2005,"Serbia",0,3,4,0,4,3,2,2,0,2,NA,NA,NA,NA,NA
"28",2005,"Spain",4,20,5,3,8,16,6,2,0,3,NA,NA,NA,NA,NA
"29",2005,"Sweden",6,17,3,3,6,11,4,1,1,3,NA,NA,NA,NA,NA
"30",2005,"Switzerland",2,5,4,0,4,3,2,2,0,2,NA,NA,NA,NA,NA
"31",2005,"Tunisia",3,16,4,1,5,13,4,1,0,3,NA,NA,NA,NA,NA
"32",2005,"Uruguay",3,6,4,0,4,3,3,1,0,3,NA,NA,NA,NA,NA
"33",2006,"Argentina",8,14,3,3,6,6,4,0,2,3,83,83,82,82,"true"
"34",2006,"Australia",4,13,3,4,7,9,5,2,0,3,76,75,75,73,"true"
"35",2006,"Belgium",5,8,3,2,5,3,2,2,1,1,75,73,71,75,"true"
"36",2006,"Brazil",2,12,4,2,6,10,5,0,1,3,85,84,85,85,"true"
"37",2006,"Colombia",1,3,0,2,2,2,1,1,0,0,77.375,78.75,76.875,75.5,"estimate"
"38",2006,"Costa Rica",2,2,1,1,2,0,1,0,1,0,72,66,70,71,"estimate"
"39",2006,"Croatia",5,13,3,2,5,8,2,2,1,2,79,79,84,77,"estimate"
"40",2006,"Denmark",3,7,1,3,4,4,2,2,0,0,78,77,78,75,"true"
"41",2006,"Egypt",8,20,7,4,11,12,7,2,2,5,69.875,69,69.125,67.75,"estimate"
"42",2006,"England",2,24,6,4,10,22,8,2,0,4,85,83,84,85,"true"
"43",2006,"France",5,17,4,5,9,12,6,2,1,2,85,88,81,83,"true"
"44",2006,"Germany",9,36,8,6,14,27,11,2,1,6,84,83,81,82,"true"
"45",2006,"Iceland",6,1,2,2,4,5,0,1,3,0,73,76,74.5,71.5,"estimate"
"46",2006,"Iran",6,19,4,4,8,13,6,2,0,2,69,75,70,70,"estimate"
"47",2006,"Japan",8,19,7,5,12,11,7,2,3,3,73,76,75,73,"estimate"
"48",2006,"Korea Republic",7,19,5,4,9,12,5,3,1,3,72,72,74,71,"estimate"
"49",2006,"Mexico",5,11,2,6,8,6,6,1,1,1,78,78,76,78,"true"
"50",2006,"Morocco",4,13,1,6,7,9,4,1,2,0,74,74,77,75,"estimate"
"51",2006,"Nigeria",3,8,6,0,6,5,4,1,1,4,74,75,76,73,"estimate"
"52",2006,"Panama",2,2,0,2,2,0,1,0,1,0,67,68,67,68,"estimate"
"53",2006,"Peru",3,0,1,1,2,3,0,0,2,0,71.5,73.625,70.5,69.125,"estimate"
"54",2006,"Poland",11,9,4,4,8,2,2,1,5,1,74,74,71,68,"true"
"55",2006,"Portugal",3,15,6,1,7,12,6,0,1,5,81,78,81,91,"true"
"56",2006,"Russia",2,4,3,2,5,2,2,2,1,1,78,79,76,77,"true"
"57",2006,"Saudi Arabia",21,26,5,13,18,5,7,5,6,3,71,70,70,70,"estimate"
"58",2006,"Senegal",2,4,2,2,4,2,2,1,1,1,74,74,74,74,"estimate"
"59",2006,"Serbia",3,7,4,2,6,4,3,2,1,3,77,77,79,77,"estimate"
"60",2006,"Spain",9,21,4,6,10,12,7,1,2,3,85,85,84,81,"true"
"61",2006,"Sweden",4,9,4,2,6,5,3,3,0,3,76,77,75,73,"true"
"62",2006,"Switzerland",5,12,2,6,8,7,4,3,1,1,76,79,76,72,"true"
"63",2006,"Tunisia",8,17,5,7,12,9,7,2,3,3,71,70,72,71,"estimate"
"64",2006,"Uruguay",0,4,0,1,1,4,1,0,0,0,77,78,72,73,"true"
"65",2007,"Argentina",3,18,6,1,7,15,6,1,0,6,83,84,83,81,"true"
"66",2007,"Australia",7,4,1,4,5,3,1,1,3,0,74,73,71,68,"true"
"67",2007,"Belgium",6,7,4,1,5,1,2,1,2,2,75,73,71,75,"true"
"68",2007,"Brazil",3,19,6,2,8,16,7,0,1,5,84,84,83,83,"true"
"69",2007,"Colombia",6,15,5,5,10,9,8,1,1,4,77.375,78.75,76.875,75.5,"estimate"
"70",2007,"Costa Rica",6,20,4,7,11,14,6,4,1,2,72,66,70,71,"estimate"
"71",2007,"Croatia",2,10,4,2,6,8,5,1,0,3,79,79,84,77,"estimate"
"72",2007,"Denmark",11,11,5,1,6,0,3,0,3,3,77,75,75,76,"true"
"73",2007,"Egypt",0,6,2,1,3,6,3,0,0,2,69.875,69,69.125,67.75,"estimate"
"74",2007,"England",7,13,4,3,7,6,3,1,3,3,84,84,83,83,"true"
"75",2007,"France",4,8,4,3,7,4,4,1,2,3,84,85,83,82,"true"
"76",2007,"Germany",7,18,5,3,8,11,5,1,2,3,82,82,81,82,"true"
"77",2007,"Iceland",8,7,4,1,5,1,1,3,1,1,73,76,74.5,71.5,"estimate"
"78",2007,"Iran",4,14,4,2,6,10,3,3,0,2,69,75,70,70,"estimate"
"79",2007,"Japan",6,14,5,3,8,8,4,3,1,1,73,76,75,73,"estimate"
"80",2007,"Korea Republic",6,6,2,4,6,0,2,2,2,0,72,72,74,71,"estimate"
"81",2007,"Mexico",20,35,9,10,19,15,12,2,5,7,78,77,77,77,"true"
"82",2007,"Morocco",3,8,1,4,5,5,3,1,1,1,74,74,77,75,"estimate"
"83",2007,"Nigeria",4,4,2,1,3,0,2,0,1,2,74,75,76,73,"estimate"
"84",2007,"Panama",12,14,4,5,9,2,5,3,1,3,67,68,67,68,"estimate"
"85",2007,"Peru",5,7,3,2,5,2,1,4,0,0,71.5,73.625,70.5,69.125,"estimate"
"86",2007,"Poland",4,17,4,3,7,13,5,1,1,4,74,75,73,69,"true"
"87",2007,"Portugal",3,10,5,1,6,7,3,3,0,2,82,78,82,78,"true"
"88",2007,"Russia",3,11,3,1,4,8,3,1,0,3,76,73,74,73,"true"
"89",2007,"Saudi Arabia",5,24,5,6,11,19,9,2,0,4,71,70,70,70,"estimate"
"90",2007,"Senegal",5,17,2,3,5,12,5,0,0,2,74,74,74,74,"estimate"
"91",2007,"Serbia",3,4,4,0,4,1,1,3,0,1,77,77,79,77,"estimate"
"92",2007,"Spain",1,9,5,0,5,8,5,0,0,5,84,83,83,80,"true"
"93",2007,"Sweden",2,9,4,1,5,7,3,2,0,2,76,79,74,75,"true"
"94",2007,"Switzerland",10,11,0,7,7,1,3,1,3,0,75,73,74,73,"true"
"95",2007,"Tunisia",1,9,2,2,4,8,3,1,0,2,71,70,72,71,"estimate"
"96",2007,"Uruguay",7,9,4,0,4,2,1,2,1,1,75,77,73,74,"true"
"97",2008,"Argentina",3,4,3,0,3,1,1,2,0,1,84,83,82,80,"true"
"98",2008,"Australia",3,11,4,2,6,8,4,1,1,3,74,74,71,67,"true"
"99",2008,"Belgium",8,7,3,1,4,1,2,0,2,2,73,73,70,72,"true"
"100",2008,"Brazil",6,10,2,4,6,4,3,2,1,0,84,82,81,82,"true"
"101",2008,"Colombia",5,6,2,3,5,1,2,0,3,0,77.375,78.75,76.875,75.5,"estimate"
"102",2008,"Costa Rica",1,6,3,1,4,5,3,0,1,3,72,66,70,71,"estimate"
"103",2008,"Croatia",9,12,5,2,7,3,4,1,2,3,79,79,84,77,"estimate"
"104",2008,"Denmark",5,4,1,3,4,1,1,1,2,1,77,76,73,72,"true"
"105",2008,"Egypt",8,27,7,4,11,19,9,1,1,6,69.875,69,69.125,67.75,"estimate"
"106",2008,"England",4,11,1,3,4,7,3,1,0,1,84,81,82,82,"true"
"107",2008,"France",4,9,2,6,8,5,5,2,1,1,83,82,82,82,"true"
"108",2008,"Germany",9,15,5,4,9,6,6,1,2,4,83,82,80,80,"true"
"109",2008,"Iceland",4,6,2,3,5,2,2,1,2,1,73,76,74.5,71.5,"estimate"
"110",2008,"Iran",6,23,8,5,13,17,9,3,1,6,69,75,70,70,"estimate"
"111",2008,"Japan",9,20,8,5,13,11,6,6,1,4,73,76,75,73,"estimate"
"112",2008,"Korea Republic",5,15,5,3,8,10,4,3,1,2,72,72,74,71,"estimate"
"113",2008,"Mexico",8,19,3,5,8,11,6,0,2,3,78,76,77,76,"true"
"114",2008,"Morocco",3,19,3,4,7,16,7,0,0,3,74,74,77,75,"estimate"
"115",2008,"Nigeria",2,12,6,1,7,10,5,1,1,4,74,75,76,73,"estimate"
"116",2008,"Panama",2,3,1,1,2,1,1,1,0,1,67,68,67,68,"estimate"
"117",2008,"Peru",3,6,3,1,4,3,2,2,0,1,71.5,73.625,70.5,69.125,"estimate"
"118",2008,"Poland",7,6,3,3,6,1,2,2,2,1,74,70,70,67,"true"
"119",2008,"Portugal",8,14,4,3,7,6,3,1,3,1,82,76,81,79,"true"
"120",2008,"Russia",6,16,4,3,7,10,5,1,1,3,78,76,74,71,"true"
"121",2008,"Saudi Arabia",10,27,6,8,14,17,10,3,1,4,71,70,70,70,"estimate"
"122",2008,"Senegal",7,10,5,1,6,3,3,2,1,2,74,74,74,74,"estimate"
"123",2008,"Serbia",2,11,2,2,4,9,3,0,1,2,77,77,79,77,"estimate"
"124",2008,"Spain",2,17,4,5,9,15,8,1,0,3,85,82,83,81,"true"
"125",2008,"Sweden",7,6,3,3,6,1,2,1,3,1,77,79,72,71,"true"
"126",2008,"Switzerland",11,16,5,5,10,5,6,0,4,2,77,76,74,71,"true"
"127",2008,"Tunisia",12,18,7,3,10,6,4,3,3,3,71,70,72,71,"estimate"
"128",2008,"Uruguay",3,9,3,1,4,6,1,3,0,1,76,74,68,73,"true"
"129",2009,"Argentina",5,13,4,2,6,8,5,0,1,3,83,80,80,79,"true"
"130",2009,"Australia",2,7,5,1,6,5,4,1,1,4,75,72,71,67,"true"
"131",2009,"Belgium",5,12,3,3,6,7,4,1,1,1,76,72,76,73,"true"
"132",2009,"Brazil",4,9,3,2,5,5,4,1,0,2,84,82,82,82,"true"
"133",2009,"Colombia",7,12,4,3,7,5,5,0,2,3,77.375,78.75,76.875,75.5,"estimate"
"134",2009,"Costa Rica",10,21,12,1,13,11,7,3,3,6,72,66,70,71,"estimate"
"135",2009,"Croatia",4,11,2,2,4,7,3,1,0,1,79,79,84,77,"estimate"
"136",2009,"Denmark",5,9,4,3,7,4,3,2,2,2,75,73,73,72,"true"
"137",2009,"Egypt",10,22,4,6,10,12,6,3,1,3,69.875,69,69.125,67.75,"estimate"
"138",2009,"England",3,22,4,2,6,19,6,0,0,4,83,80,83,82,"true"
"139",2009,"France",6,12,5,3,8,6,4,2,2,3,83,81,82,81,"true"
"140",2009,"Germany",4,13,3,3,6,9,3,2,1,2,82,81,80,80,"true"
"141",2009,"Iceland",7,8,2,4,6,1,2,2,2,0,73,76,74.5,71.5,"estimate"
"142",2009,"Iran",6,17,5,5,10,11,6,3,1,3,69,75,70,70,"estimate"
"143",2009,"Japan",6,34,7,4,11,28,9,2,0,5,73,76,75,73,"estimate"
"144",2009,"Korea Republic",4,10,3,5,8,6,5,2,1,1,72,72,74,71,"estimate"
"145",2009,"Mexico",8,28,8,5,13,20,9,2,2,7,77,74,75,74,"true"
"146",2009,"Morocco",5,2,3,2,5,3,0,3,2,0,74,74,77,75,"estimate"
"147",2009,"Nigeria",2,3,2,1,3,1,1,2,0,1,74,75,76,73,"estimate"
"148",2009,"Panama",4,10,3,2,5,6,3,0,2,2,67,68,67,68,"estimate"
"149",2009,"Peru",1,2,2,1,3,1,2,0,1,2,71.5,73.625,70.5,69.125,"estimate"
"150",2009,"Poland",3,14,3,3,6,11,3,1,2,1,72,68,68,66,"true"
"151",2009,"Portugal",0,11,4,2,6,11,5,1,0,3,82,78,80,80,"true"
"152",2009,"Russia",5,9,4,1,5,4,3,0,2,3,80,77,75,76,"true"
"153",2009,"Saudi Arabia",7,16,5,4,9,9,4,5,0,2,71,70,70,70,"estimate"
"154",2009,"Serbia",2,9,4,1,5,7,3,1,1,2,77,77,79,77,"estimate"
"155",2009,"Spain",3,14,5,2,7,11,6,0,1,4,85,83,83,81,"true"
"156",2009,"Sweden",2,9,3,1,4,7,3,0,1,2,77,77,74,73,"true"
"157",2009,"Switzerland",2,5,3,3,6,3,2,3,1,2,76,77,75,76,"true"
"158",2009,"Tunisia",2,7,2,4,6,5,2,3,1,1,71,70,72,71,"estimate"
"159",2009,"Uruguay",6,3,4,0,4,3,1,1,2,1,78,76,75,75,"true"
"160",2010,"Argentina",10,27,4,6,10,17,9,0,1,3,83,84,80,79,"true"
"161",2010,"Australia",5,8,2,4,6,3,5,0,1,2,73,71,71,69,"true"
"162",2010,"Belgium",7,6,2,2,4,1,1,1,2,0,77,73,73,76,"true"
"163",2010,"Brazil",2,10,3,1,4,8,4,0,0,3,83,80,80,81,"true"
"164",2010,"Colombia",1,2,0,2,2,1,1,1,0,0,77.375,78.75,76.875,75.5,"estimate"
"165",2010,"Costa Rica",1,2,0,1,1,1,1,0,0,0,72,66,70,71,"estimate"
"166",2010,"Croatia",1,7,2,2,4,6,3,1,0,1,79,79,84,77,"estimate"
"167",2010,"Denmark",5,8,3,3,6,3,3,2,1,2,75,73,72,72,"true"
"168",2010,"Egypt",6,21,5,3,8,15,7,1,0,4,69.875,69,69.125,67.75,"estimate"
"169",2010,"England",6,14,4,4,8,8,4,3,1,1,83,81,81,82,"true"
"170",2010,"France",7,6,4,3,7,1,3,0,4,2,82,80,82,81,"true"
"171",2010,"Germany",6,23,6,3,9,17,6,0,3,4,82,81,80,79,"true"
"172",2010,"Iceland",6,9,2,3,5,3,2,1,2,0,73,76,74.5,71.5,"estimate"
"173",2010,"Iran",6,8,4,2,6,2,4,0,2,3,69,75,70,70,"estimate"
"174",2010,"Japan",13,12,5,8,13,1,6,2,5,3,73,76,75,73,"estimate"
"175",2010,"Korea Republic",2,11,2,4,6,9,4,1,1,2,72,72,74,71,"estimate"
"176",2010,"Mexico",8,22,1,13,14,14,8,4,2,0,77,74,75,73,"true"
"177",2010,"Morocco",1,2,1,1,2,1,1,1,0,0,74,74,77,75,"estimate"
"178",2010,"Nigeria",6,18,5,4,9,12,6,3,0,4,74,75,76,73,"estimate"
"179",2010,"Panama",6,12,0,7,7,6,5,1,1,0,67,68,67,68,"estimate"
"180",2010,"Peru",0,2,0,1,1,2,1,0,0,0,71.5,73.625,70.5,69.125,"estimate"
"181",2010,"Poland",8,13,1,6,7,5,3,2,2,1,74,71,69,69,"true"
"182",2010,"Portugal",6,23,4,4,8,17,5,3,0,2,81,79,78,79,"true"
"183",2010,"Russia",3,1,1,2,3,2,1,0,2,0,79,79,76,76,"true"
"184",2010,"Saudi Arabia",1,6,1,6,7,5,3,3,1,0,71,70,70,70,"estimate"
"185",2010,"Senegal",0,8,1,1,2,8,2,0,0,1,74,74,74,74,"estimate"
"186",2010,"Serbia",9,6,3,3,6,3,1,2,3,0,77,77,79,77,"estimate"
"187",2010,"Spain",4,16,4,3,7,12,6,0,1,3,85,82,83,83,"true"
"188",2010,"Sweden",2,15,2,3,5,13,4,1,0,2,76,76,74,74,"true"
"189",2010,"Switzerland",11,9,3,5,8,2,1,4,3,1,76,79,76,76,"true"
"190",2010,"Tunisia",6,4,2,2,4,2,0,2,2,0,71,70,72,71,"estimate"
"191",2010,"Uruguay",9,11,5,1,6,2,2,2,2,1,79,81,75,77,"true"
"192",2011,"Argentina",11,30,6,8,14,19,8,6,0,2,83,87,81,77,"true"
"193",2011,"Australia",3,16,6,3,9,13,6,2,1,4,72,70,70,67,"true"
"194",2011,"Belgium",5,13,3,3,6,8,4,2,0,2,77,74,73,76,"true"
"195",2011,"Brazil",4,14,4,6,10,10,6,4,0,1,83,82,80,83,"true"
"196",2011,"Colombia",7,9,5,4,9,2,4,2,3,2,76,76,72,74,"true"
"197",2011,"Costa Rica",10,12,4,5,9,2,1,6,2,1,72,66,70,71,"estimate"
"198",2011,"Croatia",4,11,4,1,5,7,4,1,0,3,79,79,84,77,"estimate"
"199",2011,"Denmark",4,9,2,3,5,5,4,0,1,2,76,73,74,73,"true"
"200",2011,"Egypt",3,20,7,0,7,17,6,1,0,6,70,65,68,68,"true"
"201",2011,"England",3,6,2,3,5,3,3,2,0,1,85,83,83,82,"true"
"202",2011,"France",2,7,2,5,7,5,3,4,0,1,83,82,81,82,"true"
"203",2011,"Germany",9,23,3,5,8,14,6,1,1,3,84,82,82,80,"true"
"204",2011,"Iceland",2,1,2,0,2,1,1,0,1,1,73,76,74.5,71.5,"estimate"
"205",2011,"Iran",1,24,5,4,9,23,8,0,1,4,69,75,70,70,"estimate"
"206",2011,"Japan",3,16,6,2,8,13,4,4,0,2,73,76,75,73,"estimate"
"207",2011,"Korea Republic",7,24,4,4,8,17,7,1,0,4,72,72,74,71,"estimate"
"208",2011,"Mexico",10,25,3,9,12,15,8,2,2,3,76,75,72,74,"true"
"209",2011,"Morocco",3,11,2,3,5,8,3,1,1,2,74,74,77,75,"estimate"
"210",2011,"Nigeria",4,17,2,5,7,13,5,2,0,1,74,75,76,73,"estimate"
"211",2011,"Panama",7,25,9,4,13,18,9,3,1,6,67,68,67,68,"estimate"
"212",2011,"Peru",5,11,5,3,8,6,5,2,1,3,70,69,70,66,"true"
"213",2011,"Poland",8,8,0,7,7,0,3,2,2,0,74,74,73,70,"true"
"214",2011,"Portugal",6,20,3,3,6,14,5,1,0,3,82,83,80,80,"true"
"215",2011,"Russia",1,11,4,2,6,10,4,2,0,3,79,79,77,76,"true"
"216",2011,"Saudi Arabia",10,8,6,1,7,2,2,2,3,2,71,70,70,70,"estimate"
"217",2011,"Senegal",2,7,2,2,4,5,3,0,1,2,74,74,74,74,"estimate"
"218",2011,"Serbia",3,6,3,0,3,3,2,1,0,2,77,77,79,77,"estimate"
"219",2011,"Spain",4,15,3,2,5,11,5,0,0,3,87,85,86,82,"true"
"220",2011,"Sweden",4,11,4,0,4,7,3,1,0,3,77,76,76,73,"true"
"221",2011,"Switzerland",1,5,2,0,2,4,2,0,0,2,76,79,77,76,"true"
"222",2011,"Tunisia",2,14,2,2,4,12,4,0,0,2,71,70,72,71,"estimate"
"223",2011,"Uruguay",5,15,6,1,7,10,4,3,0,4,79,81,75,77,"true"
"224",2012,"Argentina",2,12,3,1,4,10,4,0,0,3,82,87,79,78,"true"
"225",2012,"Australia",3,13,3,0,3,10,2,1,0,2,71,71,70,69,"true"
"226",2012,"Belgium",5,9,2,2,4,4,2,2,0,1,80,79,79,79,"true"
"227",2012,"Brazil",6,21,0,6,6,15,4,1,1,0,83,83,81,83,"true"
"228",2012,"Colombia",0,9,2,1,3,9,3,0,0,2,77,80,77,75,"true"
"229",2012,"Costa Rica",8,13,3,3,6,5,2,2,2,1,72,66,70,71,"estimate"
"230",2012,"Croatia",9,9,3,3,6,0,3,0,3,2,79,79,84,77,"estimate"
"231",2012,"Denmark",13,7,3,4,7,6,1,1,5,0,76,77,74,74,"true"
"232",2012,"Egypt",8,30,2,12,14,22,10,2,2,1,67,62,66,67,"true"
"233",2012,"England",5,11,3,3,6,6,3,2,1,1,82,82,81,81,"true"
"234",2012,"France",5,13,2,5,7,8,4,2,1,1,81,82,81,82,"true"
"235",2012,"Germany",13,17,5,3,8,4,4,1,3,3,84,84,84,83,"true"
"236",2012,"Iceland",2,4,2,1,3,2,2,0,1,1,73,76,74.5,71.5,"estimate"
"237",2012,"Iran",9,20,7,5,12,11,5,6,1,2,69,75,70,70,"estimate"
"238",2012,"Japan",7,17,4,5,9,10,6,1,2,3,73,76,75,73,"estimate"
"239",2012,"Korea Republic",5,12,2,3,5,7,4,0,1,2,72,72,74,71,"estimate"
"240",2012,"Mexico",6,15,3,6,9,9,7,0,2,3,75,76,74,75,"true"
"241",2012,"Morocco",9,12,4,4,8,3,3,1,4,2,74,74,77,75,"estimate"
"242",2012,"Nigeria",0,3,2,1,3,3,2,1,0,2,74,75,76,73,"estimate"
"243",2012,"Panama",7,8,3,4,7,1,4,1,2,2,67,68,67,68,"estimate"
"244",2012,"Peru",6,4,4,1,5,2,2,1,2,1,73,76,74,69,"true"
"245",2012,"Poland",7,12,5,5,10,5,4,4,2,1,75,77,74,75,"true"
"246",2012,"Portugal",5,9,4,3,7,4,3,3,1,2,81,83,81,80,"true"
"247",2012,"Russia",5,12,4,3,7,7,4,3,0,4,79,81,78,76,"true"
"248",2012,"Saudi Arabia",7,13,4,3,7,6,3,2,2,1,71,70,70,70,"estimate"
"249",2012,"Senegal",5,5,3,1,4,0,2,0,2,1,74,74,74,74,"estimate"
"250",2012,"Serbia",5,9,2,2,4,4,2,1,1,1,77,77,79,77,"estimate"
"251",2012,"Spain",3,29,5,5,10,26,8,2,0,3,86,87,86,84,"true"
"252",2012,"Sweden",11,16,3,5,8,5,6,0,2,2,76,84,76,73,"true"
"253",2012,"Switzerland",8,9,2,3,5,1,2,1,2,1,77,81,78,76,"true"
"254",2012,"Tunisia",7,13,1,5,6,6,3,1,2,1,71,70,72,71,"estimate"
"255",2012,"Uruguay",4,6,3,0,3,2,1,2,0,1,79,81,75,78,"true"
"256",2013,"Argentina",1,8,3,2,5,7,3,2,0,2,82,85,80,78,"true"
"257",2013,"Australia",6,14,4,2,6,8,4,1,1,2,70,68,69,68,"true"
"258",2013,"Belgium",8,8,3,4,7,0,3,2,2,2,80,79,79,79,"true"
"259",2013,"Brazil",9,34,5,7,12,25,10,2,0,5,82,83,81,82,"true"
"260",2013,"Colombia",3,12,4,1,5,9,4,1,0,3,78,80,75,77,"true"
"261",2013,"Costa Rica",3,20,12,0,12,17,11,1,0,11,72,66,70,71,"estimate"
"262",2013,"Croatia",4,9,4,2,6,5,3,0,3,2,79,79,84,77,"estimate"
"263",2013,"Denmark",9,13,4,2,6,4,3,2,1,1,75,72,74,75,"true"
"264",2013,"Egypt",5,26,3,5,8,21,7,1,0,3,68,66,67,68,"true"
"265",2013,"England",8,16,3,5,8,8,5,1,2,3,81,84,79,81,"true"
"266",2013,"France",4,16,4,2,6,12,4,0,2,3,81,82,78,80,"true"
"267",2013,"Germany",4,13,3,1,4,9,3,1,0,3,84,85,84,82,"true"
"268",2013,"Iceland",7,7,4,2,6,0,3,1,2,2,73,76,74.5,71.5,"estimate"
"269",2013,"Iran",1,11,3,0,3,10,3,0,0,3,69,75,70,70,"estimate"
"270",2013,"Japan",16,21,4,6,10,5,5,2,3,1,73,76,75,73,"estimate"
"271",2013,"Korea Republic",11,14,6,6,12,3,5,3,4,2,72,72,74,71,"estimate"
"272",2013,"Mexico",10,14,9,3,12,4,4,5,3,3,75,76,73,74,"true"
"273",2013,"Morocco",5,7,4,2,6,2,2,3,1,2,74,74,77,75,"estimate"
"274",2013,"Nigeria",9,16,8,1,9,7,5,2,2,4,74,75,76,73,"estimate"
"275",2013,"Panama",10,22,10,3,13,12,6,5,2,4,67,68,67,68,"estimate"
"276",2013,"Peru",3,7,4,1,5,4,3,1,1,2,72,76,69,69,"true"
"277",2013,"Poland",8,12,3,4,7,4,3,2,2,1,74,79,74,67,"true"
"278",2013,"Portugal",5,9,4,2,6,4,3,2,1,3,80,82,82,80,"true"
"279",2013,"Russia",5,11,2,3,5,6,3,2,0,2,78,78,78,76,"true"
"280",2013,"Saudi Arabia",8,5,5,0,5,3,2,0,3,2,71,70,70,70,"estimate"
"281",2013,"Senegal",6,3,3,1,4,3,1,2,1,1,74,74,74,74,"estimate"
"282",2013,"Serbia",2,10,3,1,4,8,3,1,0,2,77,77,79,77,"estimate"
"283",2013,"Spain",6,24,6,3,9,18,6,3,0,4,86,86,86,83,"true"
"284",2013,"Sweden",15,20,7,3,10,5,5,2,3,3,75,81,76,73,"true"
"285",2013,"Switzerland",4,7,3,1,4,3,3,1,0,2,76,78,78,76,"true"
"286",2013,"Tunisia",2,10,4,2,6,8,4,2,0,3,71,70,72,71,"estimate"
"287",2013,"Uruguay",5,17,6,1,7,12,4,3,0,3,79,84,77,78,"true"
"288",2014,"Argentina",4,12,4,4,8,8,7,0,1,4,82,85,80,80,"true"
"289",2014,"Australia",13,9,2,3,5,4,1,1,3,0,69,71,70,65,"true"
"290",2014,"Belgium",6,24,5,5,10,18,8,2,0,4,81,75,80,79,"true"
"291",2014,"Brazil",14,16,7,2,9,2,5,2,2,3,83,82,81,83,"true"
"292",2014,"Colombia",4,13,3,3,6,9,4,2,0,3,77,77,78,75,"true"
"293",2014,"Costa Rica",8,8,4,3,7,0,1,4,2,1,72,66,70,71,"estimate"
"294",2014,"Croatia",4,14,3,3,6,10,5,0,1,2,79,79,84,77,"estimate"
"295",2014,"Denmark",4,4,2,2,4,0,2,0,2,1,73,71,74,74,"true"
"296",2014,"Egypt",2,3,3,1,4,1,2,0,2,1,69,70,67,64,"true"
"297",2014,"England",3,14,3,3,6,11,5,0,1,2,80,83,79,79,"true"
"298",2014,"France",4,25,3,8,11,21,8,2,1,2,81,82,80,80,"true"
"299",2014,"Germany",12,27,7,5,12,15,7,4,1,5,83,84,82,82,"true"
"300",2014,"Iceland",2,6,2,2,4,4,3,0,1,2,73,76,74.5,71.5,"estimate"
"301",2014,"Iran",4,7,2,3,5,3,3,1,1,1,69,75,70,70,"estimate"
"302",2014,"Japan",18,21,2,9,11,3,6,2,3,0,73,76,75,73,"estimate"
"303",2014,"Korea Republic",11,8,2,5,7,3,2,0,5,0,72,72,74,71,"estimate"
"304",2014,"Mexico",3,10,1,7,8,7,5,1,2,1,75,79,73,74,"true"
"305",2014,"Morocco",8,25,2,7,9,17,6,2,1,1,74,74,77,75,"estimate"
"306",2014,"Nigeria",14,18,7,2,9,4,4,3,2,3,74,75,76,73,"estimate"
"307",2014,"Panama",0,4,0,2,2,4,1,1,0,0,67,68,67,68,"estimate"
"308",2014,"Peru",1,2,0,1,1,1,1,0,0,0,72,77,69,70,"true"
"309",2014,"Poland",4,6,2,2,4,2,2,1,1,1,75,77,73,74,"true"
"310",2014,"Portugal",3,9,3,3,6,6,4,1,1,2,80,82,79,79,"true"
"311",2014,"Russia",2,15,3,4,7,13,5,2,0,1,76,76,75,74,"true"
"312",2014,"Saudi Arabia",7,14,6,3,9,7,5,3,1,4,71,70,70,70,"estimate"
"313",2014,"Senegal",0,5,3,0,3,5,2,1,0,2,74,74,74,74,"estimate"
"314",2014,"Serbia",7,2,2,1,3,5,0,1,2,0,77,77,79,77,"estimate"
"315",2014,"Spain",9,12,4,3,7,3,4,0,3,2,85,86,84,83,"true"
"316",2014,"Sweden",3,5,2,2,4,2,2,1,1,1,75,81,73,72,"true"
"317",2014,"Switzerland",10,13,4,3,7,3,4,1,2,2,76,76,75,74,"true"
"318",2014,"Tunisia",2,5,3,0,3,3,3,0,0,3,71,70,72,71,"estimate"
"319",2014,"Uruguay",7,7,2,2,4,0,2,1,1,1,76,82,75,76,"true"
"320",2015,"Argentina",6,11,7,0,7,5,3,3,1,3,82,86,80,81,"true"
"321",2015,"Australia",3,22,8,0,8,19,7,0,1,7,69,71,70,66,"true"
"322",2015,"Belgium",3,14,3,1,4,11,4,0,0,3,81,80,81,77,"true"
"323",2015,"Brazil",5,15,6,3,9,10,7,1,1,4,82,82,80,83,"true"
"324",2015,"Colombia",2,3,4,1,5,1,2,1,2,1,78,81,78,75,"true"
"325",2015,"Costa Rica",4,4,3,1,4,0,1,2,1,1,72,66,70,71,"estimate"
"326",2015,"Croatia",2,13,3,1,4,11,3,1,0,2,79,79,84,77,"estimate"
"327",2015,"Denmark",7,10,3,3,6,3,3,2,1,1,74,75,72,74,"true"
"328",2015,"Egypt",1,14,2,3,5,13,5,0,0,2,68,72,68,65,"true"
"329",2015,"England",0,10,3,1,4,10,4,0,0,3,80,81,78,78,"true"
"330",2015,"France",8,14,0,6,6,6,4,0,2,0,81,80,80,80,"true"
"331",2015,"Germany",6,8,2,2,4,2,2,1,1,2,84,82,82,78,"true"
"332",2015,"Iceland",3,4,3,0,3,1,1,2,0,1,73,76,74.5,71.5,"estimate"
"333",2015,"Iran",5,17,5,2,7,12,5,2,0,4,69,75,70,70,"estimate"
"334",2015,"Japan",3,22,6,3,9,19,6,3,0,3,73,76,75,73,"estimate"
"335",2015,"Korea Republic",1,27,6,5,11,26,9,2,0,5,72,72,74,71,"estimate"
"336",2015,"Mexico",6,15,4,3,7,9,3,3,1,2,76,79,77,74,"true"
"337",2015,"Morocco",4,8,4,3,7,4,3,2,2,3,74,74,77,75,"estimate"
"338",2015,"Nigeria",4,11,3,5,8,7,5,0,3,3,74,75,76,73,"estimate"
"339",2015,"Panama",5,5,2,2,4,0,1,2,1,0,67,68,67,68,"estimate"
"340",2015,"Peru",5,7,4,1,5,2,3,0,2,3,71,71,71,70,"true"
"341",2015,"Poland",5,21,3,3,6,16,5,1,0,3,75,78,72,74,"true"
"342",2015,"Portugal",4,3,2,2,4,1,2,0,2,2,80,83,80,75,"true"
"343",2015,"Russia",6,9,3,4,7,3,4,1,2,2,77,68,77,75,"true"
"344",2015,"Saudi Arabia",5,14,4,1,5,9,4,0,1,3,71,70,70,70,"estimate"
"345",2015,"Senegal",7,18,5,2,7,11,6,0,1,4,74,74,74,74,"estimate"
"346",2015,"Serbia",3,7,2,1,3,4,2,0,1,1,77,77,79,77,"estimate"
"347",2015,"Spain",1,11,3,2,5,10,5,0,0,3,83,80,84,82,"true"
"348",2015,"Sweden",7,13,4,2,6,6,5,0,1,3,74,80,75,72,"true"
"349",2015,"Switzerland",3,17,3,2,5,14,4,1,0,3,77,78,77,75,"true"
"350",2015,"Tunisia",10,18,5,2,7,8,3,3,1,3,71,70,72,71,"estimate"
"351",2015,"Uruguay",2,13,4,1,5,11,4,1,0,3,76,75,74,77,"true"
"352",2016,"Argentina",3,20,9,0,9,17,7,1,1,7,82,88,80,77,"true"
"353",2016,"Australia",4,17,4,2,6,13,4,1,1,3,72,71,72,69,"true"
"354",2016,"Belgium",8,19,4,3,7,11,4,1,2,3,81,80,82,77,"true"
"355",2016,"Brazil",5,19,7,0,7,14,4,2,1,4,83,84,80,83,"true"
"356",2016,"Colombia",8,11,7,0,7,3,3,2,2,3,76,75,77,75,"true"
"357",2016,"Costa Rica",2,12,4,1,5,10,4,1,0,3,72,66,70,71,"estimate"
"358",2016,"Croatia",3,18,4,3,7,15,5,1,1,2,79,79,84,77,"estimate"
"359",2016,"Denmark",3,12,3,2,5,9,4,0,1,2,76,74,77,75,"true"
"360",2016,"Egypt",2,8,2,4,6,6,4,1,1,2,69,69,69,67,"true"
"361",2016,"England",10,17,5,5,10,7,6,2,2,3,80,81,79,80,"true"
"362",2016,"France",11,29,9,4,13,18,10,2,1,7,82,82,82,80,"true"
"363",2016,"Germany",8,22,6,5,11,14,7,2,2,4,84,78,83,82,"true"
"364",2016,"Iceland",4,12,4,1,5,8,4,1,0,3,73,76,74.5,71.5,"estimate"
"365",2016,"Iran",1,23,4,2,6,22,6,0,0,4,69,75,70,70,"estimate"
"366",2016,"Japan",8,27,7,1,8,19,6,0,2,5,73,76,75,73,"estimate"
"367",2016,"Korea Republic",5,11,4,1,5,6,5,0,0,4,72,72,74,71,"estimate"
"368",2016,"Mexico",10,12,6,3,9,2,6,2,1,3,77,76,79,76,"true"
"369",2016,"Morocco",2,10,3,3,6,8,4,1,1,1,74,74,77,75,"estimate"
"370",2016,"Nigeria",3,10,4,1,5,7,4,1,0,3,74,75,76,73,"estimate"
"371",2016,"Panama",1,9,5,0,5,8,4,1,0,4,67,68,67,68,"estimate"
"372",2016,"Peru",7,6,5,0,5,1,1,3,1,1,68,69,66,67,"true"
"373",2016,"Poland",7,15,4,5,9,8,5,3,1,3,76,82,75,74,"true"
"374",2016,"Portugal",4,30,5,5,10,26,7,2,1,3,81,85,80,79,"true"
"375",2016,"Russia",10,10,2,5,7,0,3,1,3,0,77,68,76,77,"true"
"376",2016,"Saudi Arabia",2,12,4,1,5,10,4,1,0,3,71,70,70,70,"estimate"
"377",2016,"Senegal",0,6,3,0,3,6,3,0,0,3,74,74,74,74,"estimate"
"378",2016,"Serbia",6,10,2,2,4,4,3,1,0,1,77,77,79,77,"estimate"
"379",2016,"Spain",2,22,4,2,6,20,5,0,1,4,84,81,85,83,"true"
"380",2016,"Sweden",4,12,3,5,8,8,3,4,1,1,74,76,73,74,"true"
"381",2016,"Switzerland",6,8,3,3,6,2,3,1,2,2,78,78,76,77,"true"
"382",2016,"Tunisia",6,11,6,1,7,5,3,3,1,3,71,70,72,71,"estimate"
"383",2016,"Uruguay",2,13,6,0,6,11,5,0,1,5,78,84,75,77,"true"
"384",2017,"Argentina",5,5,3,2,5,0,2,2,1,1,83,87,83,80,"true"
"385",2017,"Australia",12,14,6,1,7,2,5,0,2,5,72,71,71,72,"true"
"386",2017,"Belgium",5,20,3,3,6,15,4,2,0,2,84,85,83,84,"true"
"387",2017,"Brazil",0,9,3,1,4,9,4,0,0,3,84,87,82,85,"true"
"388",2017,"Colombia",3,3,3,0,3,0,1,1,1,1,78,79,79,76,"true"
"389",2017,"Costa Rica",4,9,7,0,7,5,3,4,0,3,72,66,70,71,"estimate"
"390",2017,"Croatia",2,7,4,0,4,5,3,1,0,3,79,79,84,77,"estimate"
"391",2017,"Denmark",2,6,3,1,4,4,1,3,0,1,78,76,79,76,"true"
"392",2017,"Egypt",3,13,6,4,10,10,9,0,1,5,72,76,71,69,"true"
"393",2017,"England",1,5,3,2,5,4,3,2,0,3,81,82,81,81,"true"
"394",2017,"France",5,16,3,4,7,11,5,1,1,2,83,82,83,81,"true"
"395",2017,"Germany",6,29,6,2,8,23,6,2,0,5,85,82,86,84,"true"
"396",2017,"Iceland",3,6,3,2,5,3,3,0,2,3,71,77,71,69,"true"
"397",2017,"Iran",4,10,3,4,7,6,5,1,1,2,69,75,70,70,"estimate"
"398",2017,"Japan",13,17,5,4,9,4,5,2,2,4,73,76,75,73,"estimate"
"399",2017,"Korea Republic",7,7,3,3,6,0,2,3,1,1,72,72,74,71,"estimate"
"400",2017,"Mexico",9,23,10,4,14,14,10,2,2,7,78,79,78,74,"true"
"401",2017,"Morocco",4,17,4,4,8,13,6,0,2,4,74,74,77,75,"estimate"
"402",2017,"Nigeria",3,9,3,2,5,6,3,1,1,2,74,75,76,73,"estimate"
"403",2017,"Panama",5,14,7,0,7,9,5,2,0,5,67,68,67,68,"estimate"
"404",2017,"Peru",3,8,4,1,5,5,4,1,0,3,70,72,70,68,"true"
"405",2017,"Poland",4,10,3,2,5,6,3,1,1,3,79,82,77,77,"true"
"406",2017,"Portugal",8,24,6,4,10,16,6,3,1,4,83,85,82,81,"true"
"407",2017,"Russia",16,15,3,7,10,1,2,4,4,1,76,66,75,75,"true"
"408",2017,"Saudi Arabia",7,7,2,3,5,0,3,0,2,2,71,70,70,70,"estimate"
"409",2017,"Senegal",3,11,6,2,8,8,4,4,0,3,74,74,74,74,"estimate"
"410",2017,"Serbia",1,5,3,0,3,4,2,1,0,2,77,77,79,77,"estimate"
"411",2017,"Spain",3,17,3,2,5,14,4,1,0,3,85,84,85,85,"true"
"412",2017,"Sweden",1,15,4,0,4,14,4,0,0,4,76,76,76,76,"true"
"413",2017,"Switzerland",2,10,4,1,5,8,4,1,0,3,78,77,75,75,"true"
"414",2017,"Tunisia",4,4,3,2,5,0,2,1,2,1,71,70,72,71,"estimate"
"415",2017,"Uruguay",6,5,3,0,3,1,1,1,1,1,79,85,76,80,"true"
"416",2018,"Argentina",4,5,2,1,3,1,1,1,1,0,84,83,85,81,"true"
"417",2018,"Australia",2,0,1,1,2,2,0,1,1,0,72,69,72,70,"true"
"418",2018,"Belgium",5,22,3,4,7,17,6,1,0,3,83,85,83,83,"true"
"419",2018,"Brazil",3,6,4,0,4,3,2,1,1,2,86,87,86,84,"true"
"420",2018,"Colombia",3,2,2,1,3,1,0,2,1,0,79,82,79,77,"true"
"421",2018,"Costa Rica",1,3,1,1,2,2,1,0,1,0,72,66,70,71,"true"
"422",2018,"Croatia",4,5,2,2,4,1,2,1,1,1,79,79,84,77,"true"
"423",2018,"Denmark",2,4,2,4,6,2,2,3,1,0,78,77,79,76,"true"
"424",2018,"Egypt",1,0,1,0,1,1,0,0,1,0,76,72,77,74,"true"
"425",2018,"England",4,11,2,3,5,7,3,1,1,1,81,83,81,80,"true"
"426",2018,"France",9,16,4,4,8,7,6,1,1,4,85,85,84,81,"true"
"427",2018,"Germany",5,5,2,3,5,0,2,1,2,1,86,85,85,84,"true"
"428",2018,"Iceland",7,5,1,2,3,2,0,1,2,0,75,75,78,74,"true"
"429",2018,"Iran",2,6,2,2,4,4,2,1,1,0,69,75,70,70,"true"
"430",2018,"Japan",8,7,2,3,5,1,1,2,2,0,73,76,75,73,"true"
"431",2018,"Korea Republic",7,6,2,4,6,1,2,1,3,1,72,72,74,71,"true"
"432",2018,"Mexico",4,5,1,5,6,1,3,1,2,0,79,80,80,76,"true"
"433",2018,"Morocco",1,2,1,1,2,1,1,0,1,0,74,74,77,75,"true"
"434",2018,"Nigeria",3,4,2,1,3,1,1,1,1,1,74,75,76,73,"true"
"435",2018,"Panama",2,1,1,1,2,1,0,1,1,0,67,68,67,68,"true"
"436",2018,"Peru",2,7,1,3,4,5,3,0,1,0,76,79,75,74,"true"
"437",2018,"Poland",10,10,2,4,6,0,2,1,3,0,80,83,78,76,"true"
"438",2018,"Portugal",9,11,2,4,6,2,3,2,1,1,84,85,83,82,"true"
"439",2018,"Russia",14,13,5,3,8,1,2,3,3,2,79,80,78,77,"true"
"440",2018,"Saudi Arabia",4,7,1,3,4,3,3,0,1,1,71,70,70,70,"true"
"441",2018,"Senegal",2,1,1,1,2,1,0,1,1,0,74,74,74,74,"true"
"442",2018,"Serbia",8,9,2,4,6,1,2,0,4,0,77,77,79,77,"true"
"443",2018,"Spain",4,9,1,2,3,5,1,2,0,0,86,84,86,86,"true"
"444",2018,"Sweden",4,3,3,3,6,1,2,2,2,2,77,78,76,77,"true"
"445",2018,"Switzerland",2,10,1,2,3,8,2,1,0,0,78,80,78,77,"true"
"446",2018,"Tunisia",3,3,1,3,4,0,2,0,2,0,71,70,72,71,"true"
"447",2018,"Uruguay",3,8,3,2,5,5,4,0,1,2,80,86,77,80,"true"
